    ██████████
    █        █
    █ ██████ █
    █ █    █ █
    █ █ ██ █ █
    █ █ █P █ █
    █ █ ████ █
    █?█      █
    ██████████