██████████████████████████████████████
██                                  ██
██      ██                          ██
██    ██        ████████████████    ██
██  ██          ██            ██    ██
██                    █████   ██    ██
█P                      ?██   ██    ██
██                    █████   ██    ██
██  ██          ██            ██    ██
██    ██        ████████████████    ██
██      ██                          ██
██                                  ██
██████████████████████████████████████