███████████████████████
█        █      █     █      
█ ██████   █ ██ █ ███?█
█P      ████ ██   ███ █
█ ███ █ ████ ████████ █ 
█ ███ █ ████        █ █
█ ███         ████    █
███████████████████████
