    ████████████
    █        █?█
    █ ██████ █ █
    █ █    █ █ █
    █ █ ██ █ █ █
    █ █ █P █ █ █
    █ █ ████ █ █
    █ █      █ █
    █ ████████ █
    █          █
    ████████████