███████████████████
█      ██?        █
█ ███ ███████ ███ █
█   █ ███   █     █ 
█ █ ██    ████  ███  
█ █     █ █   █ ███
█ █ █████ █ ███ ███
█P█   █         ███   
███████████████████