███████████████████
█P      █      ?  █
█   ██████████    █
█ ███       ███ ███
█   ██  █ ████   █  
█ █     █ █     ███
█ █ █████ █ ███████
█   █         █   
████████████████
